74 22 0  1  2  74 74 0  1  2  21 74
74 29 14 15 16 74 74 74 74 74 28 74
74 29 74 74 74 74 74 74 74 74 28 74
74 36 61 61 48 45 74 74 74 74 35 45 
0  1  1  1  1  2  74 34 41 74 0  1 
7  8  8  8  8  9  40 40 40 40 7  8